111111111111111111111111111111111111111111111111111111111111
1U000000000000000000000000000000000000000000000000000E000101
110000000000000000000000000000000000000000000000000000000001
1D00P0000000000000000000000000000000000000000000000000000001
10000000000000000000C000000000000000000000000000000000000001
100000000000000000000000000000000000000000000000000000000001
1000000000000000000000000000000000000000000C0000000000000001
100000000000000000000000000000000000000000000000000000000001
100000000000000000000000000000000000000000000000000000000001
100000000000000000000000000000000000000000000000000000000001
100000000000000000000000000000000011111111100000000000000001
100000000000000C00000000000000000000000000000000000000000001
100000000000000000000000000000000000000000000000000000000001
10000000000000000000000000000000000000000000000C000000000001
100000000000000000001000000000000000000000000000000000000001
100000000000000000000000000000000000000000000000000000000001
100000000000000011111111111111111111111110000000000000000001
100000000000000011111111111111111111111110000000000000000001
100000000000000000000000000000000000000000000000000000000001
1000000000000000000C00C0000000000000000000000000000000000001
100000000000000000000000000000000000000000000000000000000001
100000000000000000000000000000000000000000000000000000000001
100000000000000000000000000000000000000C00000000000000000001
100000000000000000000000000000000000000000000000000000000001
100000000000000000000000000000000000000000000000000000000001
100000000000000000000000000000000000000000000000000111111111
100000000000000000000000000000000000000000000000000000000C01
111111111111111111111111111111111111111111111111111111111111