111111111111111111111111111111111111111111111111111111111111
1C00000000000000000000000000000000000000000000000000000001C1
110000000000000000000000000000000000000000000000000000000001
1000PE00C000000000000000000000000000000000000000000000000001
100000000000000000000000000000000000000000000000000000000001
100000000000000000000000000000000000000000000000000000000001
100000000000000000000000000000000000000000000000000000000001
1000000000C0000000000000000000000000000000000000000000000001
100000000000000000000000000000000000000000000000000000000001
100000000000000000000000000000000000000000000000000000000001
10000000000000000000000000000000C000000000000000000000000001
100000000000000000000000000000000000000000000000000000000001
100000000000000000000000000000000000000000000000000000000001
100000000000000000000000000000000000000000000000000000000001
100000000000000000001000000000000000000000000000000000000001
100000000000000000000000000000000000000000000000000000000001
10000000000C00001111111111111111111111111000000000C000000001
100000000000000011111111111111111111111110000000000000000001
100000000000000000000000000C00000000000000000000000000000001
100000000000000000000000000000000000000000000000000000000001
100000000000000000000000000000000000000000000000000000000001
100000000000000000000000000000000000000000000000000000000001
1000000000000000000000000000000C0000000000000000000000000001
100000000000000000000000000000000000000000000000000000000001
100000000000000000000000000000000000000000000000000000000001
10000000000000000000C000000000000000000000000000000000000001
100000000000000000000000000000000000000000000000000000000001
1111111111111111111111111111C1111111111111111111111111111111
100000000000000000000000000000000000000000000000000000000001
1000000000000000000000000000U0000000C00000000000000000000001
100000000000000000000000000000000000000000000000000000000001
100000000000000000000000000000000000000000000000000000000001
1CCCCCCCCCCCCCCCCCCCCCCCCCCCCCCCCCCCCCCCCCCCCCCCCCCCCCCCCCC1
100000000000000000000000000000000000000000000000000000000001
100000000001000000000000000000000000000000000000000000000001
10000000001C100000000000000000000000000000000000000000000001
100000000000000000000000000000000000000000000000000000000001
100000000000000000000000000000000000000000000000100000000001
100000000000000000000000000000000000000000000001C10000000001
100000000000000000000000000000000000000000000000000000000011
1C00000000000000000000000000000000000000000000000000000000C1
111111111111111111111111111111111111111111111111111111111111